WAAAAAAAAA
WAAAAAAAAA
AAAAAAAWAA
AAAAAWAAAA
AAAAAAAAAA
AAAAAPTTTA
AAAAAAAAAA
AAAAAAAAAA
AAAAAAAAAA
AAAAAAAAAA