WAAAAAAAAA
WAAAAAAAAA
AAAAAAAWAA
AAAAAWAAAA
AAAAAAAAAA
AAAAPPTTTA
AAAAAAAAAA
AAAAAAAAAA
AAAAAAAAAA
AAAAAAAAAA