AAAAAAAAAA    
AAAAAAAAAA
AAAAAAAAAA
AATAAAAAAA
AATAAAAAAA
TTPTTWTTAA
AATAAAAAAA
AATAAAAAAA
AAAAAAAAAA
AAAAAAAAAA