----------
W-------W-
--MMMMM---
-MMGMMMM--
-MMRMRGM--
-MMMPMMMME
-MGRMRMM--
-MMMMGMM--
--MMMMM---
W-------W-