----G----R
---MMM---W
--MMWMM--M
-MMTTTMM-M
RMMMPMMMRM
-MTTTTMM-M
-MTMMTMW-M
-MTMMMWW-M
-MM-G-MM-W
-GR-E-GR-G