----G-----
---TMT----
--TMMMT---
-TMWWWMT--
RMMWPWMMR-
-TMWWWMT--
--TMMMT---
---TMT----
----G-----
----E-----