AAAAAAAAAA
AAAAAAAAAA
AAAAAAAAAA
AATAAAAAAA
AATAAAAAAA
TTTTTPTTTT
AATAAAAAAA
AATAAAAAAA
AAAAAAAAAA
AAAAAAAAAA