----------
----------
----------
--WWWW----
-MMMMMM---
-MPRRGGE--
-MMMMMM---
--WWWW----
----------
----------