----------
-----R----
-----M----
-----M----
-----M----
-RMGMPMMME
-----M----
-----M----
-----M----
-----R----