AAAAAAAAAA
AAAAAAAAAA
AAPGRGRAAA
AAGRWWGAAA
AARGWWRAAA
AAGRGRGAAA
AARGRGEAAA
AAAAAAAAAA
AAAAAAAAAA
AAAAAAAAAA