----------
----------
--PGRGR---
--GRWWG---
--RGWWR---
--GRGRG---
--RGRGE---
----------
----------
----------