AAAAAAAAAA    
AAAAAAAAAA
AAAAAAAAAA
AAMAAAAAAA
AAMAAAAAAA
GMPRGWRGAA
AARAAAAAAA
AARAAAAAAA
AAAAAAAAAA
AAAAAAAAAA