----------
----------
----G-----
MM-MMM-MM-
RMWMMMWMMG
MM--M--MM-
----M-----
RMWMPMMMME
----------
----------