**********
**********
**MMMMM***
**MMPMM***
**MMMMM***
**MMMMM***
**MMMMM***
**********
**********
**********