----------
-----R----
-----M----
-----M----
-----M----
-RMGMPWMME
-----M----
-----M----
-----M----
-----R----