----R-----
----M-----
----M-----
----M-----
RMMMPMMMME
----M-----
----M-----
----M-----
----R-----
----------