----------
----------
RGRGRGRGRG
GRGR-----R
RGRG-WWW-G
GWGR-----R
RGRGPGRGRG
WW-RE-W---
----------
----------