----------
--------RM
----MMWRMG
MG--M-----
RMWMP-----
----M-----
----M-M---
----RRMGME
------M---
----------