----------
----------
--MMMMM---
-MMGMMMM--
-MMRMRGM--
-MMMPMMMME
-MGRMRMM--
-MMMMGMM--
--MMMMM---
----------