----------
----------
----------
-----MM---
-----MM---
--MMMPMRGE
-------MM-
-------MM-
----------
----------